11111
1P001
10001
1E001
11111
