111111111111111
1P0000000000001
101111101111101
100000101000001
101110101011101
100010101000001
111010101011111
1C00000000C0001
101011111110101
1000000000000E1
101111011111101
100000101000001
101110101011101
1C00000000000C1
111111111111111
