11111
1P0C1
10001
1E0C1
11111
